C 10,236,190
F 10,4,2

NO ./walls/pfour.png
WE ./walls/pnine.png
EA ./walls/psix.png
SO ./walls/pten.png

 111 1111
1W0010001
100000001
111111111
