C 10,236,190
F 10,4,2

NO ./walls/pfour.png
WE ./walls/pnine.png
EA ./walls/psix.png
SO ./walls/pten.png

              111111111    111
1111    1    10W001111     101
        1    1111111111    111
