C 242,236,190
F 154,59,54

NO ./walls/wall_0.png
WE ./walls/wall_1.png
EA ./walls/wall_2.png
SO ./walls/wall_3.png

1111111111
1N00000011
1000000001
1000010001
1000001001
1111111111
