C 122,234,222
F 10,10,1

NO ./path_to_the_north_texture
WE ./path_to_the_west_texture
EA ./path_to_the_east_texture
SO ./path_to_the_south_texture

11111111111111111111
10000000000000000001
10000000000000000001
10000000000010000001
100000000000W1000001
10000000000000000001
10000000000000000001
10000000000000000001
11111111111111111111
