NO ./walls/pfour.png
WE ./walls/pnine.png
EA ./walls/psix.png
SO ./walls/pten.png

C 10,236,190
F 50,1,60

11111111111111
1000000000001
10000000000001
10000100000101
10000100000101
10000100000101
10000000000101
10000100000101
10000100000101
10000010000101
100S0000000101
10000000000001
11111111111111
