C 122,234,222
F 10,10,1

NO ./path_to_the_north_texture
WE ./path_to_the_west_texture
EA ./path_to_the_east_texture
SO ./path_to_the_south_texture

1111111111111111111
10000000000000000W1
1000000000000000001
1000000000000000001
1000000000000000001
1000000000000000001
1000000000000000001
1000000000000000001
1111111111111111111
