NO ./path_to_the_north_texture
WE ./path_to_the_west_texture
EA ./path_to_the_east_texture
SO ./path_to_the_south_texture

C 111,234,222
F 10,0,10

1111111111111111111
100001010111      1
1100W00011111     1
1111011011111111111
1000000000000000001
1111111111111111111
