
NO ./path_to_the_north_texture
WE ./path_to_the_west_texture
EA ./path_to_the_east_texture
SO ./path_to_the_south_texture

C 122,234,222
F 10,0,10

111111111111111111
1000W010111      1
110000011111     1
111101111111     1
111111111111111111
