C 122,234,222
F 10,0,10
NO ./path_to_the_north_texture
WE ./path_to_the_west_texture
EA ./path_to_the_east_texture
SO ./path_to_the_south_texture

1111111111111111
1000W010111
11000001110111111111111
11110111 1111
1111111111111111
