NO ./walls/peight.png
WE ./walls/pnine.png
EA ./walls/psix.png
SO ./walls/pten.png

F 18,53,25
C 153,204,255

111111111111111111111
1E0000000000000000001
111111111111111111111