NO ./walls/pfour.png
WE ./walls/pnine.png
EA ./walls/psix.png
SO ./walls/pten.png

C 10,236,190
F 10,4,2

11111111111111
10000000000001
100000000000W1
10000100000101
10000100000101
10000100000101
10000100000101
10000100000101
10000100000101
10000100000101
10000100000101
10000100000101
10000100000101
10000100000101
10000100000101
10000100000101
10000100000101
10000100000101
10000100000101
10000100000101
10000100000101
10000100000101
10000100000101
10000100000101
10000100000101
10000100000101
10000100000101
10000100000101
10000100000101
11111111111111
