C 242,236,190
F 154,59,54

NO ./walls/wall_0.png
WE ./walls/wall_1.png
EA ./walls/wall_2.png
SO ./walls/wall_3.png

1111111111111111111
00000000000000000W1
1000000000000000001
1000000000000000001
1000000000000000001
1000000000000000001
1000000000000000001
1000000000000000001
1111111111111111111
