C 122,234,222
F 10,10,1

NO ./path_to_the_north_texture
WE ./path_to_the_west_texture
EA ./path_to_the_east_texture
SO ./path_to_the_south_texture

111111111111111
100000000000001
100000000000101
1000000W0000011
100000000000001
111111111111111
