NO ./path_to_no
WE ./path_to_we
EA ./path_to_ea
SO ./path_to_so

F 111,111,311
C 122,222,222

1111111111111111111111
111100000000000011
100000000000000001
1111111111111111111111

