N ./path_to_no
W ./path_to_we
E ./path_to_ea
S ./path_to_so

F 10,70,15000
C 122,234,222

111111111111111111
111110000111100001111
100000001  100000111
1000000111100000111
1111111111111111111111

