C 242,236,190
F 154,59,54

NO   ./lol .png
WE ./walls/psix.png
EA ./walls/ptwo.png
SO ./walls/pnine.png

1 1 1 1 11111111111111
110101010000000000001
100000000010000000001
100000000001000000001
100000000000000000001
10000000000W000000001
100000000000000000001
111111111111111111111
