C 242,236,190
F 154,59,54

NO ./walls/wall_0.png
WE ./walls/wall_1.png
EA ./walls/wall_2.png
SO ./walls/wall_3.png

111111111111111111111
100000000000000000001
100000000010000000001
100000000001000000001
100000000000000000001
10000000000W000000001
100000000000000000001
100000000000000000001
111111111111111111111
